Z714,Z716,Z716,Z716,Z716,Z716,Z716,Z716,Z717,Z715,Z715,Z715,Z715,Z715,Z718,Z715,Z715,Z715,Z715,Z715,Z715,Z715,Z715,Z715,Z715,Z716,Z715,Z715,Z715,Z715,Z715,Z719
Z770,Z743,Z774,Z774,Z774,Z774,Z774,Z746,Z773,Z743,Z774,Z774,Z774,Z774,Z774,Z774,Z774,Z774,Z774,Z774,Z774,Z774,Z774,Z774,Z774,Z774,Z774,Z774,Z774,Z774,Z746,Z803
Z770,Z771,Z772,Z772,Z772,Z772,Z772,Z772,Z744,Z772,Z772,Z772,Z772,Z772,Z772,Z772,Z772,Z772,Z772,Z772,Z772,Z772,Z772,Z772,Z772,Z772,Z772,Z772,Z772,Z772,Z774,Z803
Z770,Z771,Z772,Z772,Z772,Z772,Z772,Z772,Z800,Z772,Z772,Z772,Z772,Z772,Z772,Z772,Z772,Z772,Z772,Z772,Z772,Z772,Z772,Z772,Z772,Z772,Z772,Z772,Z772,Z772,Z774,Z803
Z770,Z799,Z774,Z774,Z774,Z774,Z774,Z799,Z776,Z771,Z772,Z772,Z772,Z772,Z772,Z772,Z772,Z772,Z772,Z772,Z772,Z772,Z772,Z772,Z772,Z772,Z772,Z772,Z772,Z772,Z774,Z803
Z854,Z855,Z855,Z855,Z855,Z855,Z883,Z883,Z748,Z771,Z772,Z772,Z772,Z772,Z772,Z772,Z772,Z772,Z772,Z772,Z772,Z772,Z772,Z772,Z772,Z772,Z772,Z772,Z772,Z772,Z774,Z803
Z770,Z743,Z774,Z774,Z774,Z774,Z774,Z774,Z774,Z772,Z772,Z772,Z772,Z772,Z772,Z772,Z772,Z772,Z772,Z772,Z772,Z772,Z772,Z772,Z772,Z772,Z772,Z772,Z772,Z772,Z774,Z803
Z770,Z771,Z772,Z772,Z772,Z772,Z772,Z772,Z772,Z772,Z772,Z772,Z772,Z772,Z772,Z772,Z772,Z772,Z772,Z772,Z772,Z772,Z772,Z772,Z772,Z772,Z772,Z772,Z772,Z772,Z774,Z775
Z770,Z771,Z772,Z772,Z772,Z772,Z772,Z772,Z774,Z774,Z774,Z774,Z774,Z774,Z774,Z774,Z774,Z774,Z772,Z772,Z772,Z772,Z772,Z772,Z772,Z772,Z772,Z772,Z772,Z772,Z774,Z803
Z770,Z771,Z772,Z772,Z772,Z772,Z772,Z774,Z888,Z855,Z855,Z855,Z855,Z855,Z855,Z855,Z855,Z856,Z774,Z772,Z772,Z772,Z772,Z772,Z772,Z772,Z772,Z772,Z772,Z772,Z774,Z803
Z770,Z771,Z772,Z772,Z772,Z772,Z772,Z774,Z804,Z743,Z774,Z774,Z774,Z774,Z774,Z774,Z774,Z774,Z772,Z772,Z772,Z772,Z772,Z772,Z772,Z772,Z772,Z772,Z772,Z772,Z774,Z803
Z770,Z771,Z772,Z772,Z772,Z772,Z772,Z774,Z804,Z771,Z772,Z772,Z772,Z772,Z772,Z772,Z772,Z772,Z772,Z772,Z772,Z772,Z772,Z772,Z772,Z772,Z772,Z772,Z772,Z772,Z774,Z803
Z770,Z771,Z772,Z772,Z772,Z772,Z772,Z774,Z804,Z771,Z772,Z772,Z772,Z772,Z772,Z772,Z772,Z772,Z772,Z772,Z772,Z772,Z772,Z772,Z772,Z772,Z772,Z772,Z772,Z772,Z774,Z803
Z770,Z771,Z772,Z772,Z772,Z772,Z772,Z774,Z804,Z771,Z772,Z772,Z772,Z772,Z772,Z772,Z772,Z774,Z774,Z774,Z774,Z774,Z774,Z774,Z774,Z774,Z774,Z774,Z774,Z774,Z799,Z803
Z770,Z771,Z772,Z772,Z772,Z772,Z772,Z774,Z804,Z771,Z772,Z772,Z772,Z772,Z772,Z772,Z774,Z830,Z827,Z827,Z827,Z827,Z827,Z827,Z827,Z827,Z827,Z827,Z827,Z827,Z827,Z831
Z770,Z771,Z772,Z772,Z772,Z772,Z772,Z774,Z804,Z771,Z772,Z772,Z772,Z772,Z772,Z772,Z774,Z775,Z699,Z699,Z699,Z699,Z699,Z699,Z699,Z699,Z699,Z699,Z699,Z699,Z699,Z699
Z770,Z799,Z774,Z774,Z774,Z774,Z774,Z799,Z804,Z799,Z774,Z774,Z774,Z774,Z774,Z774,Z799,Z775,Z699,Z699,Z699,Z699,Z699,Z699,Z699,Z699,Z699,Z699,Z699,Z699,Z699,Z699
Z826,Z827,Z827,Z827,Z827,Z827,Z827,Z827,Z832,Z827,Z827,Z827,Z827,Z827,Z827,Z827,Z827,Z831,Z699,Z699,Z699,Z699,Z699,Z699,Z699,Z699,Z699,Z699,Z699,Z699,Z699,Z699
