A861,A863,A863,A863,A863,A863,A863,A863,A863,A863,A863,A863,A863,A863,A863,A863,A863,A863,A863,A863,A863,A863,A863,A863,A863,A863,A863,A863,A863,A863,A863,A866
A917,Z919,Z919,Z919,Z919,Z919,Z919,Z919,Z919,Z919,Z919,Z919,Z919,Z919,Z919,Z919,Z919,Z919,Z919,Z919,Z919,Z919,Z919,Z919,Z919,Z919,Z919,Z919,Z919,Z919,Z919,A922
A917,Z919,Z755,Z919,Z755,Z919,Z919,Z919,Z919,Z919,Z919,Z919,Z919,Z755,Z919,Z919,Z919,Z919,Z919,Z919,Z919,Z919,Z755,Z919,Z919,Z919,Z919,Z919,Z919,Z919,Z755,A922
A917,Z919,Z919,Z919,Z919,Z919,Z919,Z919,Z919,Z919,Z919,Z755,Z919,Z919,Z919,Z919,Z919,Z919,Z919,Z919,Z919,Z919,Z919,Z919,Z919,Z919,Z919,Z919,Z919,Z919,Z919,A922
A917,Z919,Z919,Z919,Z919,Z919,Z919,Z919,Z919,Z919,Z919,Z919,Z919,Z919,Z919,Z919,Z919,Z919,Z919,Z755,Z919,Z919,Z919,Z919,Z919,Z919,Z919,Z919,Z919,Z919,Z919,A922
A917,Z755,Z919,Z919,Z919,Z919,Z919,Z919,Z919,Z919,Z919,Z755,Z919,Z919,Z919,Z919,Z919,Z919,Z919,Z919,Z919,Z919,Z919,Z919,Z919,Z919,Z919,Z755,Z919,Z919,Z919,A922
A917,Z919,Z919,Z919,Z919,Z755,Z919,Z919,Z919,Z919,Z919,Z919,Z919,Z919,Z609,Z610,Z610,Z610,Z611,Z919,Z755,Z919,Z919,Z919,Z919,Z919,Z919,Z919,Z919,Z919,Z919,A922
A917,Z919,Z919,Z919,Z919,Z919,Z919,Z755,Z919,Z919,Z755,Z919,Z919,Z919,Z637,Z919,Z919,Z919,Z639,Z919,Z919,Z919,Z919,Z919,Z919,Z919,Z919,Z919,Z919,Z919,Z919,A922
A917,Z755,Z919,Z919,Z919,Z919,Z919,Z919,Z919,Z919,Z919,Z919,Z919,Z919,Z637,Z919,Z919,Z919,Z639,Z755,Z919,Z919,Z919,Z755,Z919,Z919,Z919,Z919,Z919,Z919,Z919,A922
A917,Z919,Z919,Z919,Z755,Z919,Z919,Z919,Z755,Z919,Z919,Z919,Z919,Z919,Z637,Z919,Z919,Z919,Z639,Z919,Z919,Z919,Z919,Z919,Z919,Z919,Z919,Z755,Z919,Z919,Z919,A922
A917,Z919,Z919,Z919,Z919,Z919,Z919,Z919,Z919,Z919,Z919,Z919,Z919,Z919,Z665,Z666,Z666,Z666,Z667,Z919,Z919,Z919,Z919,Z919,Z919,Z919,Z919,Z919,Z919,Z919,Z919,A922
A917,Z919,Z919,Z919,Z919,Z919,Z919,Z919,Z919,Z919,Z919,Z919,Z919,Z919,Z919,Z919,Z919,Z755,Z919,Z919,Z919,Z919,Z919,Z919,Z919,Z919,Z919,Z919,Z755,Z919,Z919,A922
A917,Z919,Z755,Z919,Z919,Z919,Z919,Z919,Z919,Z919,Z919,Z919,Z755,Z919,Z919,Z919,Z919,Z919,Z919,Z919,Z919,Z919,Z919,Z755,Z919,Z919,Z919,Z919,Z919,Z919,Z919,A922
A917,Z919,Z919,Z919,Z919,Z919,Z919,Z919,Z919,Z919,Z919,Z919,Z919,Z919,Z919,Z919,Z919,Z919,Z919,Z755,Z919,Z919,Z919,Z919,Z919,Z919,Z919,Z919,Z919,Z919,Z919,A922
A917,Z919,Z919,Z919,Z919,Z919,Z919,Z919,Z919,Z919,Z919,Z755,Z919,Z919,Z919,Z919,Z919,Z755,Z919,Z919,Z919,Z919,Z919,Z919,Z919,Z919,Z919,Z919,Z919,Z919,Z919,A922
A917,Z919,Z755,Z919,Z919,Z919,Z755,Z919,Z919,Z919,Z919,Z919,Z919,Z755,Z919,Z919,Z919,Z919,Z919,Z755,Z919,Z919,Z919,Z919,Z919,Z919,Z919,Z919,Z919,Z919,Z919,A922
A917,Z919,Z919,Z919,Z919,Z919,Z919,Z919,Z919,Z755,Z919,Z919,Z919,Z919,Z919,Z919,Z919,Z919,Z919,Z919,Z919,Z919,Z919,Z919,Z919,Z919,Z919,Z919,Z919,Z919,Z919,A922
A973,A974,A974,A974,A974,A974,A974,A974,A974,A974,A974,A974,A974,A974,A974,A974,A974,A974,A974,A974,A974,A974,A974,A974,A974,A974,A974,A974,A974,A974,A974,A978
